3

9 7 2 2
1 1 1 1 4 4 4
1 3 0 1 1 4 4
1 3 0 0 1 4 4
1 3 0 2 1 4 4
1 1 2 0 1 1 1
4 1 0 2 0 0 1
4 1 0 0 0 0 1
4 1 0 0 1 1 1
4 1 1 1 1 4 4

7 7 3 3
1 1 1 1 1 1 1
1 3 0 0 0 3 1
1 0 0 2 0 0 1
1 0 2 0 2 0 1
1 0 0 2 0 0 1
1 3 0 0 0 3 1
1 1 1 1 1 1 1

6 5 4 2
1 1 1 1 1
1 3 3 3 1
1 2 2 2 1
1 0 0 0 1
1 0 0 0 1
1 1 1 1 1
